file_name,start_time_df,events_count_start,urls_count_start,events_count_end,urls_count_end,new_events_in_db,new_urls_in_db,time_stamp,elapsed_time
db.py,41:21.8,1510,5574,1220,5574,-290,0,41:26.0,0 days 00:00:04.241310
emails.py,08:32.0,1220,5574,1226,5574,6,0,08:52.3,0 days 00:00:20.307484
emails.py,18:15.7,1226,5574,1232,5574,6,0,18:54.0,0 days 00:00:38.252084
emails.py,36:01.8,1232,5574,1255,5575,23,1,36:46.7,0 days 00:00:44.867970
db.py,39:54.4,1255,5575,1213,5575,-42,0,39:57.5,0 days 00:00:03.144173
db.py,49:35.0,1213,5575,1203,5575,-10,0,49:38.0,0 days 00:00:02.971983
emails.py,2025-05-03 20:06:27.361999,1203,5575,1226,5575,23,0,2025-05-03 20:07:20.691367,0 days 00:00:53.329368
emails.py,2025-05-03 20:12:02.840781,1226,5575,1248,5575,22,0,2025-05-03 20:12:52.729435,0 days 00:00:49.888654
db.py,2025-05-03 20:13:29.207495,1248,5575,1206,5575,-42,0,2025-05-03 20:13:32.175174,0 days 00:00:02.967679
emails.py,2025-05-08 08:23:20.754555,0,5575,22,5575,22,0,2025-05-08 08:24:25.842767,0 days 00:01:05.088212
gs.py,2025-05-08 08:24:29.375117,22,5575,22,5575,0,0,2025-05-08 08:34:00.694804,0 days 00:09:31.319687
rd_ext.py,2025-05-08 10:36:43.953058,137,5575,446,5580,309,5,2025-05-08 11:01:09.886369,0 days 00:24:25.933311
rd_ext.py,2025-05-12 11:45:02.973775,1155,6000,1156,6000,1,0,2025-05-12 11:45:03.169438,0 days 00:00:00.195663
rd_ext.py,2025-05-12 11:48:14.122009,1156,6000,1157,6000,1,0,2025-05-12 11:48:14.333549,0 days 00:00:00.211540
emails.py,2025-05-12 20:02:36.925360,0,6000,23,6000,23,0,2025-05-12 20:03:41.778644,0 days 00:01:04.853284
gs.py,2025-05-12 20:03:44.348917,23,6000,23,6000,0,0,2025-05-12 20:20:21.696912,0 days 00:16:37.347995
ebs.py,2025-05-13 17:40:43.077098,149,6023,172,6024,23,1,2025-05-13 18:48:36.190435,0 days 01:07:53.113337
ebs.py,2025-05-13 19:45:47.585208,194,6024,307,6031,113,7,2025-05-13 21:10:46.476472,0 days 01:24:58.891264
rd_ext.py,2025-05-13 21:16:05.946454,307,6031,548,6033,241,2,2025-05-13 21:35:51.825982,0 days 00:19:45.879528
scraper.py,2025-05-13 21:35:55.297186,548,6033,1648,6510,1100,477,2025-05-13 21:39:32.765508,0 days 00:03:37.468322
fb.py,2025-05-14 05:23:27.356396,1648,6510,1648,6510,0,0,2025-05-14 05:31:22.289394,0 days 00:07:54.932998
fb.py,2025-05-14 05:33:32.035229,1648,6510,1648,6510,0,0,2025-05-14 05:35:59.324767,0 days 00:02:27.289538
fb.py,2025-05-14 05:36:42.802512,1648,6510,1852,6524,204,14,2025-05-14 10:45:54.453989,0 days 05:09:11.651477
db.py,2025-05-14 10:45:57.992386,1852,6524,1136,6524,-716,0,2025-05-14 10:46:02.642074,0 days 00:00:04.649688
clean_up.py,2025-05-14 10:46:06.309081,1136,6524,994,6524,-142,0,2025-05-14 10:46:09.404043,0 days 00:00:03.094962
dedup_llm.py,2025-05-14 10:46:12.624942,994,6524,994,6524,0,0,2025-05-14 10:46:23.972548,0 days 00:00:11.347606
irrelevant_rows.py,2025-05-14 10:46:27.273915,994,6524,935,6524,-59,0,2025-05-14 10:56:53.377943,0 days 00:10:26.104028
rd_ext.py,2025-05-14 11:16:29.681070,935,6524,1256,6524,321,0,2025-05-14 11:43:13.832007,0 days 00:26:44.150937
rd_ext.py,2025-05-14 11:49:52.873173,1256,6524,1257,6524,1,0,2025-05-14 11:51:02.619897,0 days 00:01:09.746724
rd_ext.py,2025-05-14 12:10:42.204195,1257,6524,1258,6524,1,0,2025-05-14 12:11:56.305995,0 days 00:01:14.101800
rd_ext.py,2025-05-14 16:28:44.979124,1258,6524,1292,6524,34,0,2025-05-14 16:29:56.890363,0 days 00:01:11.911239
db.py,2025-05-14 16:34:02.666446,1292,6524,1035,6524,-257,0,2025-05-14 16:34:05.928621,0 days 00:00:03.262175
llm.py,2025-05-14 16:41:18.069871,1035,6524,1037,6524,2,0,2025-05-14 16:41:29.415178,0 days 00:00:11.345307
llm.py,2025-05-14 16:42:29.186879,1037,6524,1039,6524,2,0,2025-05-14 16:42:34.180833,0 days 00:00:04.993954
db.py,2025-05-14 16:42:46.821160,1039,6524,1035,6524,-4,0,2025-05-14 16:42:49.335002,0 days 00:00:02.513842
emails.py,2025-05-14 17:38:51.533396,0,6524,21,6524,21,0,2025-05-14 17:39:55.376091,0 days 00:01:03.842695
gs.py,2025-05-14 17:39:58.718885,21,6524,21,6524,0,0,2025-05-14 17:48:53.543175,0 days 00:08:54.824290
ebs.py,2025-05-14 17:48:57.127126,21,6524,90,6524,69,0,2025-05-14 18:28:22.630611,0 days 00:39:25.503485
rd_ext.py,2025-05-14 18:28:29.392959,90,6524,488,6526,398,2,2025-05-14 18:52:37.110659,0 days 00:24:07.717700
scraper.py,2025-05-14 18:52:41.834654,488,6526,1586,6914,1098,388,2025-05-14 18:59:32.148725,0 days 00:06:50.314071
scraper.py,2025-05-14 20:56:31.954689,3573,6937,5071,6941,1498,4,2025-05-14 22:04:08.779601,0 days 01:07:36.824912
fb.py,2025-05-14 18:59:35.473418,1586,6914,5142,6947,3556,33,2025-05-14 23:39:43.972254,0 days 04:40:08.498836
db.py,2025-05-14 23:39:47.197211,5142,6947,1265,6947,-3877,0,2025-05-14 23:39:51.911514,0 days 00:00:04.714303
clean_up.py,2025-05-14 23:39:55.275894,1265,6947,1113,6947,-152,0,2025-05-14 23:39:58.581581,0 days 00:00:03.305687
dedup_llm.py,2025-05-14 23:40:01.813797,1113,6947,1113,6947,0,0,2025-05-14 23:40:25.692311,0 days 00:00:23.878514
irrelevant_rows.py,2025-05-14 23:40:28.812468,1113,6947,1071,6947,-42,0,2025-05-14 23:47:51.445159,0 days 00:07:22.632691
dedup_llm.py,2025-05-15 07:52:57.058614,1071,6947,1071,6947,0,0,2025-05-15 07:57:14.687419,0 days 00:04:17.628805
rd_ext.py,2025-05-15 08:14:22.287784,1071,6947,1072,6947,1,0,2025-05-15 08:15:28.696352,0 days 00:01:06.408568
rd_ext.py,2025-05-15 08:23:05.834293,1072,6947,1106,6947,34,0,2025-05-15 08:24:52.821428,0 days 00:01:46.987135
db.py,2025-05-15 08:26:25.781664,1106,6947,1093,6947,-13,0,2025-05-15 08:26:28.052344,0 days 00:00:02.270680
rd_ext.py,2025-05-15 08:28:58.433174,1093,6947,1094,6947,1,0,2025-05-15 08:28:58.722239,0 days 00:00:00.289065
db.py,2025-05-15 08:36:31.271616,1094,6947,1093,6947,-1,0,2025-05-15 08:36:33.642095,0 days 00:00:02.370479
rd_ext.py,2025-05-15 08:37:03.692669,1093,6947,1094,6947,1,0,2025-05-15 08:37:04.491979,0 days 00:00:00.799310
db.py,2025-05-15 08:45:29.545853,1094,6947,1094,6947,0,0,2025-05-15 08:45:31.816074,0 days 00:00:02.270221
fb.py,2025-05-15 19:44:49.096359,1094,6947,1096,6948,2,1,2025-05-15 19:46:19.681793,0 days 00:01:30.585434
fb.py,2025-05-15 20:04:17.648531,1096,6948,1102,6951,6,3,2025-05-15 20:07:09.742400,0 days 00:02:52.093869
db.py,2025-05-15 20:26:15.370788,1102,6951,1097,6951,-5,0,2025-05-15 20:26:17.833469,0 days 00:00:02.462681
fb.py,2025-05-16 10:21:56.305214,1132,6954,1132,6954,0,0,2025-05-16 10:31:52.083806,0 days 00:09:55.778592
fb.py,2025-05-16 10:19:03.154125,1132,6954,1203,6956,71,2,2025-05-16 11:46:07.057009,0 days 01:27:03.902884
